NO ./texture/wall.xpm
SO ./texture/square.xpm
WE ./texture/ground.xpm
EA ./texture/item.xpm

C 220,200,220
F 225,30,0

        1111111111111111111111111
        1000000000110000000000001
        1011000001110000000000001
        1001000000000000000000001
111111111011000001110000000000001
100000000011000001110111111111111
11110111111111011100000010001
11110111111111011100000010001
11110111111111011100000010001
11110111111111011100000010001
11110111111111011100000010001
11110111111111011100000010001
11110111111111011100000010001
11110111111111011100000010001
11110111111111011100000010001
11110111111111011100000010001
11110111111111011100000010001
11110111111111011100000010001
11110111111111011100000010001
11110111111111011100000010001
111101000001111011101010011001
11000000110101011100000010001
10000000000000001100000010101
1000N000000000001101010010001
1100000111010101111101000000111
11100111 1110101 101111010001
11100111 1110101 101111010001
11100111 1110101 101111010001
11110111 1110101 101111010001
11110111 1110101 101111010001
11111111 1111111 111111111111
